5.ox
o...oo..oo
o.....o...
..........
...o.o.o..
oo.......o
