5.ox
.....o..oo
......o...
..........
.....o.o..
oo.......o
